11111111111
1P000000001
10110E01101
101CC000101
10000000001
1000CC00001
1CC0000CC01
10100000101
10110001101
10000000001
11111111111